NO 	OTRO
CP 	CERTIFICADO PARCIAL
CF 	CERTIFICADO FINAL
AC 	ACTA
RN 	RENUNCIA
RS 	RESCISION
AV 	AL VISAR
MO 	MODIFICADO
IP 	INTERVENCION PROFESIONAL
CC 	CAMBIO COLEGIADO
CT 	CAMBIO DE PROMOTOR
CO 	COPIA
MA 	MODIFICADO DE ACTA
AX 	ANEXO
MC 	MINUTA A CUENTA
BA 	PROYECTO BASICO
AN 	ANULADO
MI 	MINUTAS
LG 	LIQUIDACION GASTOS COLEGIALES
RH 	RECLAMACION DE HONORARIOS
CA 	COLEGIADO AGREGADO
