00	DESCONOCIDO
AD	ALDEA
AL	ALAMEDA
AP	APARTAMENTO
AV	AVENIDA
BL	BLOQUE
BO	BARRIO
CH	CHALET
CL	CALLE
CM	CAMINO
CO	COLONIA
CR	CARRETERA
CS	CASERÍO
CT	CUESTA
ED	EDIFICIO
GL	GLORIETA
GR	GRUPO
LG	LUGAR
MC	MERCADO
MN	MUNICIPIO
MZ	MANZANA
PB	POBLADO
PG	POLÍGONO
PJ	PASAJE
PQ	PARQUE
PR	PROLONGACIÓN
PS	PASEO
PZ	PLAZA
RB	RAMBLA
RD	RONDA
SC	 
TR	TRAVESÍA
UR	URBANIZACIÓN
