SC	
00	-
AL	ALAMEDA
AD	ALDEA
AP	APARTAMENTO
AV	AVENIDA
BO	BARRIO
BL	BLOQUE
CL	CALLE
CM	CAMINO
CR	CARRETERA
CH	CHALET
CS	CASERÍO
CO	COLONIA
CT	CUESTA
ED	EDIFICIO
GL	GLORIETA
GR	GRUPO
LG	LUGAR
MZ	MANZANA
MC	MERCADO
MN	MUNICIPIO
PQ	PARQUE
PJ	PASAJE
PS	PASEO
PZ	PLAZA
PB	POBLADO
PG	POLÍGONO
PR	PROLONGACIÓN
RB	RAMBLA
RD	RONDA
TR	TRAVESÍA
UR	URBANIZACIÓN
RC	RECINTO
PA	PARAJE
FN	FINCA
