CA	CARRERA	
GV	GRAN VIA	
PD	PARTIDA	
PP	PUERTA	
CN	CALLEJON	
00	.	
AL	ALAMEDA	C
AD	ALDEA	C
AO	APARTADO	
AP	APARTAMENTO	C
AV	AVENIDA	C
BO	BARRIO	C
BL	BLOQUE	C
CL	CALLE	C
CM	CAMINO	C
CR	CARRETERA	C
CS	CASERÍO	C
CH	CHALET	C
CO	COLONIA	C
CT	CUESTA	C
ED	EDIFICIO	C
GL	GLORIETA	C
GR	GRUPO	C
LG	LUGAR	C
MZ	MANZANA	C
MC	MERCADO	C
MN	MUNICIPIO	C
PQ	PARQUE	C
PJ	PASAJE	C
PS	PASEO	C
PI	PISTA	
PZ	PLAZA	C
PB	POBLADO	C
PG	POLÍGONO	C
PR	PROLONGACIÓN	C
RB	RAMBLA	C
RD	RONDA	C
TR	TRAVESÍA	C
UR	URBANIZACIÓN	C
SE	SENDA	
