HEC	CURSO DE CALCULO DE ESTRUCTURAS	C
FGP	JORNADA DE GESTIÓN DE LA PROFESIÓN	J
FNT	JORNADA DE NORMATIVA TÉCNICA	J
FJT	JORNADA TÉCNICO-COMERCIAL	J
FMC	JORNADA DE MATERIALES DE LA CONSTRUCCIÓN	J
FI	JORNADA DE HERRAMIENTAS INFORMATICAS	J
FSS	JORNADA DE SEGURIDAD Y SALUD	J
FCT	JORNADA  DE INSTALACIONES Y SISTEMAS	J
HCT	CURSO DE SISTEMAS E INSTALACIONES	C
HNT	CURSO DE NORMATIVA TECNICA	C
HMC	CURSO DE MATERIALES DE LA CONSTRUCCION	C
HI	CURSO DE HERRAMIENTAS INFORMATICAS	C
HSS	CURSO DE SEGURIDAD Y SALUD	C
TNT	TALLER DE NORMATIVA TECNICA	J
MNT	MESA REDONDA DE NORMATIVA TECNICA	J
CNT	CONFERENCIA	J
PMC	PRESENTACION MATERIALES DE LA CONSTRUCCION	J
SSS	SEMINARIO DE SEGURIDAD Y SALUD	J
HIE	CURSO DE UTILIZACION DE INSTRUMENTOS Y EQUIPOS	C
HEA	CURSO DE ESTUDIO DE ELEMENTOS CONSTRUCTIVOS	C
HGU	CURSO DE GESTION DEL URBANISMO	C
HAE	CURSOS Y EVENTOS CULTURAL	C
CTE	CAFE TERTULIA DE LA EDIFICACION	J
CUR	CURSO	C
ACF	ACTIVIDAD LUDICO-FESTIVA	J
VT	VISITA TÉCNICA	J
