ES	ESTRADA	
SU	SUBZONA	
SE	SECTOR	
MU	MUELLE	
PA	PARCELA	
AR	AREA	
UA	UNIDAD DE ACTUACION	
UE	UNIDAD DE EJECUCION	
SC	 	
B 	*	
AT	ALTO	
AB	AMBITO	
RE	RESIDENCIAL	
VI	VIA	
AL	ALAMEDA	C
AD	ALDEA	C
AO	APARTADO	
AP	APARTAMENTO	C
AV	AVDA.	C
BO	B?	C
BL	BL.	C
CL	C/	C
CM	CAMINO	C
CR	CRTA.	C
Ca	CASA	
CS	CASER?O	C
CH	CHALET	C
CO	COLONIA	C
CT	CUESTA	C
ED	EDIFICIO	C
GL	GLORIETA	C
GR	GRUPO	C
LG	LUGAR	C
MZ	MANZANA	C
MC	MERCADO	C
MN	MUNICIPIO	C
PQ	PARQUE	C
PJ	PASAJE	C
PS	P?	C
PZ	PZA.	C
PB	POBLADO	C
PG	POL.	C
PR	PROLONGACIËN	C
RB	RAMBLA	C
RD	RONDA	C
TR	TRAVES?A	C
UR	URB.	C
PE	PARAJE	
AN	ANDADOR	
