SC	
00	--
AL	ALAMEDA
AD	ALDEA
AP	APARTAMENT
AV	AVINGUDA
BO	BARRI
BL	BLOC
CL	CARRER
CM	CAMÍ
CR	CARRETERA
CH	XALET
CS	CASERIU
CO	COLÒNIA
CT	COSTA
ED	EDIFICI
GL	GLORIETA
GR	GRUP
LG	LLOC
MZ	MANZANA
MC	MERCAT
MN	MUNICIPI
PQ	PARC
PJ	PASSATGE
PS	PASSEIG
PZ	PLAÇA
PB	POBLAT
PG	POLÍGON
PR	PROLONGACIÓ
RB	RAMBLA
RD	RONDA
TR	TRAVESSIA
UR	URBANITZACIÓ
PA	PARTIDA
PL	PLAÇA
